11111111111111111111111111111111111111111
1000000C000P000NE000000010001111111111111
10000000000001000000000000001111111111111
10000000000001000000000000001111111111111
10000000000001000000000000001111111111111
10000000000001000000000000001111111111111
10000000000001000000000000001111111111111
10000000000001000000000000001111111111111
10000000000001000000000000001111111111111
11111111111111111111111111111111111111111
11111111111111111111111111111111111111111
11111111111111111111111111111111111111111
11111111111111111111111111111111111111111
11111111111111111111111111111111111111111
11111111111111111111111111111111111111111
11111111111111111111111111111111111111111
11111111111111111111111111111111111111111
11111111111111111111111111111111111111111
11111111111111111111111111111111111111111
11111111111111111111111111111111111111111
11111111111111111111111111111111111111111
11111111111111111111111111111111111111111
