1111111111111
1000000C000P1
111C1CC0000C1
1000CC0001101
1000C00000EN1
1111111111111
