1111111111
1000C000C1
1C000C0001
1000C00N01
1P0000C001
1001110C01
10011100E1
1111111111
