1111111111
1000000001
10000C0001
1000C00001
1P00000001
1001110001
1001110001
1111111111
